Trophy Eyes: [alternative emo, anthem emo, aussie emo, pop punk]
Radiohead: [alternative rock, art rock, melancholia, oxford indie, permanent wave, rock]
Biffy Clyro: [modern rock, scottish rock]
The Killers: [alternative rock, dance rock, modern rock, permanent wave, rock]
Two Door Cinema Club: [indie rock, indietronica, irish rock, modern alternative rock, modern rock, northern irish indie]
Hot Mulligan: [alternative emo, emo, pop punk]
Modern Baseball: [alternative emo, emo, philly indie, pov indie]
Car Seat Headrest: [furry, indie rock, pov indie]
Angels & Airwaves: [pop punk, socal pop punk]
blink-182: [alternative metal, pop punk, punk, socal pop punk]
The Smashing Pumpkins: [alternative metal, alternative rock, grunge, permanent wave, rock, spacegrunge]
Oasis: [beatlesque, britpop, madchester, permanent wave, rock]
Muse: [alternative rock, modern rock, permanent wave, rock]
Editors: [british indie rock, indie rock, modern rock, new rave]
Foo Fighters: [alternative metal, alternative rock, modern rock, permanent wave, post-grunge, rock]
Alkaline Trio: [chicago punk, emo, pop punk, post-hardcore, punk, skate punk]
Pink Floyd: [album rock, art rock, classic rock, progressive rock, psychedelic rock, rock, symphonic rock]
The Cure: [new wave, permanent wave, rock, uk post-punk]
System Of A Down: [alternative metal, nu metal, rap metal, rock]
The Front Bottoms: [asbury park indie, emo, new jersey indie, pov indie]
The White Stripes: [alternative rock, blues rock, detroit rock, garage rock, modern blues rock, permanent wave, punk blues, rock]
Dreamwell: [new england emo]
Spanish Love Songs: [alternative emo, la indie]
Dermot Kennedy: [folk-pop, irish pop, uk pop]
Lil Yachty: [atl hip hop, melodic rap, rap, trap]
Jeff Rosenstock: [alternative emo, bubblegrunge, folk punk, indie punk, modern power pop]
For Those I Love: [irish hip hop]
Genesis Owusu: [australian hip hop]
Weatherday: [5th wave emo, lo-fi emo, lo-fi indie, noise pop]
La Dispute: [alternative emo, emo, grand rapids indie]
Deftones: [alternative metal, nu metal, rap metal, rock, sacramento indie]
Geese: [crank wave]
Alvvays: [art pop, chamber pop, dream pop, dreamo, indie pop, indie rock, noise pop, shoegaze, toronto indie]
Foxing: [alternative emo, dreamo, emo, stl indie]
Shadow Academy: []
yeule: [ambient pop, escape room]
Pool Kids: [5th wave emo, bubblegrunge, diy emo, midwest emo]
Touché Amoré: [alternative emo, chaotic hardcore, dreamo, emo, melodic hardcore, modern melodic hardcore, post-hardcore]
DMA'S: [australian indie, australian surf rock]
Black Country, New Road: [crank wave, indie rock, london indie, uk post-punk revival]